1 1 1 1 1 1 1 1 1 1 1 1 1 1 1 1 1 1 1 1 1 1 1 1 1 1 1 1 1 1 1 1 1 1 1 1 1 1 1 1 
1 0 0 3 0 0 0 0 2 4 0 0 4 0 0 0 2 0 0 1 1 10 10 10 10 0 0 0 0 0 0 0 0 0 0 0 0 0 0 1
1 0 3 3 3 0 0 0 0 0 0 0 0 0 0 0 0 0 0 1 1 10 10 10 0 0 0 0 0 0 1 1 0 1 0 0 0 1 0 1 
1 0 0 6 0 0 0 0 0 7 9 7 0 0 0 0 0 0 0 1 1 0 0 0 0 1 1 0 0 0 0 1 1 0 0 0 0 1 0 1 
1 0 0 0 0 0 0 0 0 0 0 0 0 0 0 0 0 0 0 1 1 0 0 0 1 1 0 0 3 0 0 1 1 4 0 0 1 1 0 1
1 2 0 0 0 0 0 0 0 0 0 0 0 0 3 0 0 0 0 1 1 11 0 0 1 1 0 0 0 1 0 0 1 1 4 0 1 0 0 1
1 0 0 0 10 10 10 0 0 0 0 0 0 3 3 3 0 0 0 1 1 0 0 0 0 1 1 0 1 0 0 0 0 1 1 1 1 0 0 1 
1 0 0 10 10 10 10 10 0 0 2 2 0 0 6 0 4 0 0 1 1 0 0 0 0 0 1 1 0 0 0 0 0 1 1 0 0 0 0 1
1 0 0 0 10 10 10 0 0 0 0 0 0 0 0 0 0 0 0 1 1 0 0 0 0 10 10 1 1 0 0 0 0 0 1 1 0 5 3 1 
1 0 0 0 0 0 0 0 0 0 0 5 0 0 0 0 5 0 0 1 1 1 0 0 0 10 10 1 1 0 0 1 0 0 1 1 0 0 0 1
1 0 0 0 0 0 0 0 0 0 5 5 5 0 0 5 5 5 0 1 1 2 1 4 0 0 1 1 0 0 0 0 1 0 1 1 1 0 0 1 
1 0 0 0 0 0 0 1 0 0 0 6 0 0 0 0 6 0 0 1 1 0 0 1 0 2 1 1 0 0 0 0 0 1 1 0 0 0 0 1 
1 0 1 1 1 1 0 1 0 1 1 1 1 1 1 1 1 1 1 1 1 0 0 1 0 1 1 0 0 0 0 1 0 0 1 0 0 0 0 1 
1 0 0 4 1 0 0 1 0 0 0 0 0 0 0 0 0 0 0 1 1 0 3 3 1 1 5 0 1 1 0 1 1 0 1 1 0 0 0 1
1 0 1 1 1 0 0 1 1 1 1 1 1 1 0 0 0 0 0 1 1 0 0 0 1 1 5 1 0 0 0 0 1 1 1 1 0 0 0 1
1 0 1 0 1 0 0 1 0 1 0 0 0 1 0 0 0 0 0 1 1 0 0 0 1 1 1 0 4 2 0 0 0 0 0 1 1 0 4 1
1 1 1 0 0 0 0 1 0 1 8 1 0 1 0 0 0 0 0 1 1 0 0 1 1 0 0 0 0 3 3 3 0 0 0 1 1 0 0 1
1 0 0 0 1 1 1 1 0 1 1 1 0 1 0 0 0 0 0 1 1 0 0 0 0 0 0 0 0 0 0 0 0 0 0 0 1 1 0 1
1 2 4 0 0 0 0 0 0 0 0 0 0 1 0 0 0 0 0 0 0 0 0 0 0 0 0 0 0 0 0 0 0 5 5 5 0 1 0 1
1 1 1 1 1 1 1 1 1 1 1 1 1 1 1 1 1 1 0 0 0 0 1 1 1 1 1 1 1 1 1 1 1 1 1 1 1 1 1 1
1 15 1 1 1 1 1 1 1 1 1 1 1 1 1 1 1 1 0 0 0 0 1 1 1 1 1 1 1 1 1 1 1 1 1 1 1 1 1 1
1 0 1 12 0 0 1 0 0 3 5 3 5 3 0 2 10 0 0 0 0 0 0 13 0 0 0 0 0 0 4 0 0 0 0 0 0 0 0 1 
1 0 1 0 0 0 1 5 3 3 5 0 0 0 0 14 10 0 10 1 1 0 0 0 0 0 0 0 4 4 0 14 4 0 0 10 0 0 0 1 
1 0 1 0 1 0 1 0 3 5 0 0 5 3 3 10 10 0 10 1 1 0 0 0 0 0 0 4 4 0 0 0 4 4 0 10 0 0 0 1
1 0 1 0 1 0 1 0 0 0 0 3 5 5 10 10 10 0 10 1 1 0 0 0 0 4 4 4 0 0 0 0 0 4 4 4 0 0 0 1 
1 0 1 0 1 0 1 0 0 0 0 3 3 0 10 10 0 0 0 1 1 0 0 0 4 4 0 0 0 0 0 0 0 0 0 4 4 0 0 1
1 0 1 0 1 0 1 0 0 0 0 0 0 0 0 0 0 0 0 1 1 0 0 0 2 2 2 2 2 2 2 0 2 2 2 2 2 0 0 1
1 0 0 0 1 0 1 0 0 0 0 0 0 0 0 0 0 0 0 1 1 0 0 0 2 0 0 0 0 0 0 0 0 0 0 0 2 0 0 1 
1 0 0 0 1 0 1 0 0 0 0 0 0 0 0 0 0 0 0 1 1 0 0 0 2 0 0 0 0 0 0 0 4 4 4 0 2 0 0 1 
1 0 0 0 1 0 1 0 0 4 2 0 0 0 6 0 6 0 0 1 1 0 0 0 2 0 0 0 0 0 0 0 4 0 4 0 2 0 0 1
1 0 0 0 1 0 1 0 0 0 0 0 0 0 0 6 0 0 0 1 1 0 0 0 2 0 0 0 0 0 0 0 4 4 4 0 2 0 0 1
1 0 0 0 1 0 1 0 0 0 0 0 0 6 0 0 6 6 0 1 1 0 0 0 2 0 0 0 0 0 0 0 0 0 0 0 2 0 0 1
1 0 0 0 1 0 1 0 0 6 0 0 6 0 0 6 6 0 0 1 1 5 0 0 2 0 2 0 0 2 0 0 0 0 0 0 0 0 0 1
1 0 0 0 2 0 1 0 0 0 6 6 6 0 6 6 0 0 0 1 1 3 0 0 2 0 2 2 2 2 0 0 0 0 0 0 2 0 0 1 
1 0 0 0 4 0 1 0 0 0 0 0 6 6 6 0 0 0 0 1 1 5 0 3 2 0 2 0 0 2 0 0 0 0 0 0 2 0 0 1
1 0 0 0 2 0 1 0 0 0 2 0 0 6 6 0 0 0 0 1 1 0 0 5 2 0 2 0 0 2 0 0 0 0 0 0 2 0 0 1 
1 0 3 0 0 0 1 0 0 0 0 0 0 6 6 0 0 0 0 1 1 3 0 0 2 2 2 2 2 2 2 2 2 2 2 2 2 0 0 1
1 3 3 3 0 0 1 0 0 0 0 0 0 6 14 0 0 0 0 1 1 0 5 0 3 0 0 0 3 0 0 0 5 0 0 0 3 0 0 1 
1 0 6 0 0 0 0 0 0 0 0 0 0 6 6 0 0 0 0 1 1 0 0 0 0 0 5 0 0 0 3 0 0 0 3 0 0 0 5 1 
1 1 1 1 1 1 1 1 1 1 1 1 1 1 1 1 1 1 1 1 1 1 1 1 1 1 1 1 1 1 1 1 1 1 1 1 1 1 1 1 
0 16 0